1111111111111111111111111
10000000001100000000000E1
1011110111110111110111101
1000000000000000000000001
1011101111011110111101111
1011101111011110111101111
1000000CCCCCCC000000000C1
1111011110111110111101111
1111011110CC1110111101111
1P00C0CC0C0C00000000000C1
1111111111111111111111111
